http://game-sokoban.com/index.php?mode=level&lid=44344
